0xc030a0,0x101010
0xff4080,0x101010
0xe0e0e0,0x101010
0x404040,0x101010
0xffff50,0x101010
0xffa030,0x101010
0x3050ff,0x101010
0x30ffff,0x101010
0x30ff50,0x101010
0xff4040,0x101010
0xe0e0e0,0x101080
0xe03030,0x101080
0xe0d030,0x101080
0xe04080,0x101080
0x70d040,0x101080
0x000000,0x3020c0
0x101010,0x3020c0
0x101010,0xe0e0e0
0x101010,0xe0e060
0x101010,0xd08010
0x101010,0x700090
0x101010,0x106070
0x1060e0,0x101070
0xe040a0,0x10e0f0
0xff5070,0xa01030
0xf01010,0xe0e060
0x101010,0x10b010
0xf0f0f0,0xb0b0b0
0xf0a020,0xd02020
0xe0e0e0,0x606070
0x101010,0x606060
0xd0c030,0x604020
0x10b0f0,0x101010
0x706020,0x101010
0x5020d0,0x501020
0xe050b0,0x501020
0x101010,0x202080
0x701070,0x208020
0xf080c0,0xc03090
0x9070f0,0x304090
0x000000,0xa02020
0x10d0e0,0x107010
0x10e0e0,0x6090f0
0x000000,0x10e0f0
0x0070e0,0x00e0f0
0xb050e0,0x00e0f0
0x30f070,0x109010
0x101080,0x10a010
0xd0d0f0,0x206070
